"filename", "language", "vue", "TypeScript", "PostCSS", "XML", "comment", "blank", "total"
"d:\projectCode\blog\src\App.vue", "vue", 64, 0, 0, 0, 0, 6, 70
"d:\projectCode\blog\src\api\article.ts", "TypeScript", 0, 20, 0, 0, 0, 6, 26
"d:\projectCode\blog\src\api\favorite.ts", "TypeScript", 0, 61, 0, 0, 0, 21, 82
"d:\projectCode\blog\src\api\friend.ts", "TypeScript", 0, 48, 0, 0, 0, 11, 59
"d:\projectCode\blog\src\api\guestbook.ts", "TypeScript", 0, 27, 0, 0, 0, 6, 33
"d:\projectCode\blog\src\api\history.ts", "TypeScript", 0, 37, 0, 0, 0, 13, 50
"d:\projectCode\blog\src\api\hotspot.ts", "TypeScript", 0, 114, 0, 0, 0, 20, 134
"d:\projectCode\blog\src\api\label.ts", "TypeScript", 0, 44, 0, 0, 0, 14, 58
"d:\projectCode\blog\src\api\like.ts", "TypeScript", 0, 61, 0, 0, 0, 21, 82
"d:\projectCode\blog\src\api\post.ts", "TypeScript", 0, 19, 0, 0, 0, 6, 25
"d:\projectCode\blog\src\api\search.ts", "TypeScript", 0, 217, 0, 0, 0, 19, 236
"d:\projectCode\blog\src\api\searchUser.ts", "TypeScript", 0, 7, 0, 0, 0, 3, 10
"d:\projectCode\blog\src\api\thread.ts", "TypeScript", 0, 24, 0, 0, 0, 6, 30
"d:\projectCode\blog\src\api\user.ts", "TypeScript", 0, 91, 0, 0, 0, 20, 111
"d:\projectCode\blog\src\api\visible.ts", "TypeScript", 0, 47, 0, 0, 0, 15, 62
"d:\projectCode\blog\src\assets\avatar_female.svg", "XML", 0, 0, 0, 1, 0, 0, 1
"d:\projectCode\blog\src\assets\avatar_male.svg", "XML", 0, 0, 0, 1, 0, 0, 1
"d:\projectCode\blog\src\assets\blogger.svg", "XML", 0, 0, 0, 1, 0, 0, 1
"d:\projectCode\blog\src\assets\favorite.svg", "XML", 0, 0, 0, 1, 0, 0, 1
"d:\projectCode\blog\src\assets\favorites-fill.svg", "XML", 0, 0, 0, 1, 0, 0, 1
"d:\projectCode\blog\src\assets\favorites.svg", "XML", 0, 0, 0, 1, 0, 0, 1
"d:\projectCode\blog\src\assets\invisible.svg", "XML", 0, 0, 0, 1, 0, 0, 1
"d:\projectCode\blog\src\assets\like.svg", "XML", 0, 0, 0, 1, 0, 0, 1
"d:\projectCode\blog\src\assets\like_fill.svg", "XML", 0, 0, 0, 1, 0, 0, 1
"d:\projectCode\blog\src\assets\moonIcon.svg", "XML", 0, 0, 0, 1, 0, 0, 1
"d:\projectCode\blog\src\assets\normail.css", "PostCSS", 0, 0, 146, 0, 0, 34, 180
"d:\projectCode\blog\src\assets\search.svg", "XML", 0, 0, 0, 1, 0, 0, 1
"d:\projectCode\blog\src\assets\sunIcon.svg", "XML", 0, 0, 0, 1, 0, 0, 1
"d:\projectCode\blog\src\assets\tag.svg", "XML", 0, 0, 0, 1, 0, 0, 1
"d:\projectCode\blog\src\components\Article\article.vue", "vue", 491, 0, 0, 0, 24, 15, 530
"d:\projectCode\blog\src\components\Article\articleList.vue", "vue", 180, 0, 0, 0, 117, 16, 313
"d:\projectCode\blog\src\components\Article\articleModify.vue", "vue", 181, 0, 0, 0, 1, 7, 189
"d:\projectCode\blog\src\components\Editor\editor.vue", "vue", 256, 0, 0, 0, 1, 11, 268
"d:\projectCode\blog\src\components\Header\header.vue", "vue", 153, 0, 0, 0, 42, 16, 211
"d:\projectCode\blog\src\components\Homepage\articles.vue", "vue", 42, 0, 0, 0, 0, 3, 45
"d:\projectCode\blog\src\components\Homepage\loading.vue", "vue", 5, 0, 0, 0, 0, 1, 6
"d:\projectCode\blog\src\components\Homepage\posts.vue", "vue", 46, 0, 0, 0, 0, 3, 49
"d:\projectCode\blog\src\components\Homepage\users.vue", "vue", 50, 0, 0, 0, 0, 2, 52
"d:\projectCode\blog\src\components\Post\post.vue", "vue", 739, 0, 0, 0, 12, 34, 785
"d:\projectCode\blog\src\components\Post\postList.vue", "vue", 169, 0, 0, 0, 111, 14, 294
"d:\projectCode\blog\src\components\Post\postModify.vue", "vue", 96, 0, 0, 0, 1, 8, 105
"d:\projectCode\blog\src\components\Search\search.vue", "vue", 213, 0, 0, 0, 0, 7, 220
"d:\projectCode\blog\src\components\Thread\thread.vue", "vue", 188, 0, 0, 0, 2, 13, 203
"d:\projectCode\blog\src\components\Thread\threadList.vue", "vue", 337, 0, 0, 0, 5, 14, 356
"d:\projectCode\blog\src\components\Thread\threadModify.vue", "vue", 101, 0, 0, 0, 1, 9, 111
"d:\projectCode\blog\src\components\User\Board\board.vue", "vue", 36, 0, 0, 0, 0, 3, 39
"d:\projectCode\blog\src\components\User\Board\myMessage.vue", "vue", 56, 0, 0, 0, 0, 4, 60
"d:\projectCode\blog\src\components\User\Fav\articles.vue", "vue", 38, 0, 0, 0, 0, 4, 42
"d:\projectCode\blog\src\components\User\Fav\fav.vue", "vue", 53, 0, 0, 0, 0, 3, 56
"d:\projectCode\blog\src\components\User\Fav\post.vue", "vue", 37, 0, 0, 0, 0, 3, 40
"d:\projectCode\blog\src\components\User\Fav\threads.vue", "vue", 39, 0, 0, 0, 0, 4, 43
"d:\projectCode\blog\src\components\User\Friend\circle.vue", "vue", 65, 0, 0, 0, 0, 4, 69
"d:\projectCode\blog\src\components\User\Friend\friend.vue", "vue", 68, 0, 0, 0, 0, 3, 71
"d:\projectCode\blog\src\components\User\Friend\friendApply.vue", "vue", 112, 0, 0, 0, 0, 4, 116
"d:\projectCode\blog\src\components\User\Friend\friendList.vue", "vue", 96, 0, 0, 0, 0, 4, 100
"d:\projectCode\blog\src\components\User\Friend\myApply.vue", "vue", 44, 0, 0, 0, 0, 3, 47
"d:\projectCode\blog\src\components\User\History\history.vue", "vue", 3, 0, 0, 0, 0, 1, 4
"d:\projectCode\blog\src\components\User\login.vue", "vue", 556, 0, 0, 0, 3, 13, 572
"d:\projectCode\blog\src\components\User\logout.vue", "vue", 35, 0, 0, 0, 0, 2, 37
"d:\projectCode\blog\src\components\User\modifyInfo.vue", "vue", 325, 0, 0, 0, 9, 11, 345
"d:\projectCode\blog\src\components\User\overview.vue", "vue", 135, 0, 0, 0, 7, 6, 148
"d:\projectCode\blog\src\components\User\personalInfo.vue", "vue", 96, 0, 0, 0, 6, 3, 105
"d:\projectCode\blog\src\components\User\userMsgBoard.vue", "vue", 125, 0, 0, 0, 0, 8, 133
"d:\projectCode\blog\src\components\User\userPage.vue", "vue", 277, 0, 0, 0, 3, 14, 294
"d:\projectCode\blog\src\components\alertCard.vue", "vue", 35, 0, 0, 0, 0, 3, 38
"d:\projectCode\blog\src\components\articleCard.vue", "vue", 106, 0, 0, 0, 0, 9, 115
"d:\projectCode\blog\src\components\labelCard.vue", "vue", 21, 0, 0, 0, 0, 2, 23
"d:\projectCode\blog\src\components\levelCard.vue", "vue", 115, 0, 0, 0, 0, 2, 117
"d:\projectCode\blog\src\components\messageCard.vue", "vue", 88, 0, 0, 0, 0, 3, 91
"d:\projectCode\blog\src\components\postCard.vue", "vue", 106, 0, 0, 0, 0, 9, 115
"d:\projectCode\blog\src\components\threadCard.vue", "vue", 151, 0, 0, 0, 4, 8, 163
"d:\projectCode\blog\src\components\userCard.vue", "vue", 76, 0, 0, 0, 0, 4, 80
"d:\projectCode\blog\src\hooks\countDown.ts", "TypeScript", 0, 14, 0, 0, 0, 2, 16
"d:\projectCode\blog\src\hooks\stars.ts", "TypeScript", 0, 68, 0, 0, 1, 3, 72
"d:\projectCode\blog\src\index.css", "PostCSS", 0, 0, 68, 0, 5, 9, 82
"d:\projectCode\blog\src\main.ts", "TypeScript", 0, 50, 0, 0, 3, 5, 58
"d:\projectCode\blog\src\request.ts", "TypeScript", 0, 7, 0, 0, 0, 3, 10
"d:\projectCode\blog\src\router\router.ts", "TypeScript", 0, 233, 0, 0, 7, 10, 250
"d:\projectCode\blog\src\shims.d.ts", "TypeScript", 0, 7, 0, 0, 0, 1, 8
"d:\projectCode\blog\src\stores\store.ts", "TypeScript", 0, 107, 0, 0, 27, 14, 148
"d:\projectCode\blog\src\views\articlePage.vue", "vue", 13, 0, 0, 0, 0, 2, 15
"d:\projectCode\blog\src\views\homepage.vue", "vue", 512, 0, 0, 0, 67, 10, 589
"d:\projectCode\blog\src\views\personalPage.vue", "vue", 143, 0, 0, 0, 2, 5, 150
"d:\projectCode\blog\src\views\postPage.vue", "vue", 13, 0, 0, 0, 0, 2, 15
"d:\projectCode\blog\src\views\threadPage.vue", "vue", 13, 0, 0, 0, 0, 2, 15
"d:\projectCode\blog\src\vite-env.d.ts", "TypeScript", 0, 0, 0, 0, 1, 1, 2
"Total", "-", 6899, 1303, 214, 13, 462, 600, 9491